+--------------------+
|                    |
|                    |
|            GX      |
|   X       XXX      |
|  XXXX   XXXXX      |
| XXXX    X  XX      |
|   SX               |
|                    |
+--------------------+
